-18
17
-8
6
000000000000000000000000000000000000
100000000000000000000000000000000010
100000000000000000000000000000000010
100000000000000000000000000000000010
100000000000000000000000000000000010
100000000000000000000000000000000010
111111110000000000000000000111111110
111111111111111111111111111111111110
111111111111111111111111111111111110
111111111111111111111111111111111110
111111111111111111111111111111111110
111111111111111111111111111111111110
111111111111111111111111111111111110
111111111111111111111111111111111110
111111111111111111111111111111111110
1
4
